xxxxxxxxxxxxxxxxxxxxxxxx
x     
x     xxxxx
x     x   x
x     x b x 
x     x   x 
x     x   xxxxxxxx
x     x          x
x     x          x
x     x          x
x     xxxxxxxx   x
x            x h x
x            x   x
x            xxxxx
x
x
x
x
